2 0 0 5 0 5 5 0 5 0 0 0 0
0 1 1 1 5 1 5 1 0 1 1 1 0
5 1 0 0 0 0 0 0 0 0 0 1 0
5 1 0 1 1 1 0 1 1 1 0 1 5
0 0 0 1 0 5 41 5 0 1 5 5 0
5 1 5 1 5 1 0 1 0 1 0 1 5
5 1 5 5 0 5 0 5 0 0 0 0 0
0 1 5 1 0 1 41 1 5 1 1 1 1
0 1 0 0 0 5 0 5 0 5 0 5 0
0 1 1 1 5 1 0 1 5 1 5 1 0
41 0 0 0 0 0 1 0 0 0 0 0 41
120