0 0 0 5 0 1 0 5 0 0 0 0 0
0 1 0 1 5 1 0 1 0 1 42 1 0
0 0 0 5 0 1 0 1 5 0 0 0 0
5 1 0 1 5 1 43 1 5 1 5 1 5
0 5 5 0 0 5 0 1 0 0 5 5 5
5 1 1 1 1 1 0 1 1 1 1 1 0
0 5 5 5 5 1 0 5 0 5 5 0 0
5 1 0 1 0 1 0 1 5 1 0 1 0
0 5 43 5 0 1 41 1 5 0 42 0 5
0 1 5 1 5 1 0 1 0 1 0 1 5
0 5 0 0 0 5 0 1 0 5 0 5 5
120